1111111111111111111111111111111111
1P110000000CC000000000000000000001
1010010100100000101001000000010101
10100100101010100010010000CC010101
10000000000CC000000000000000000011
1111111111111111111111111111111111