111111111111111111
1C00C100000E1CC
10000100C000100011
1P00C000C000011111
111111111111111111