1111111111
1PEC000001
1111111111