1111111111111
1C00C100000E1
10000100C0001
1P00C000C0010
1111111111111