111111111111111111111
100000000000000000001
100000000000000000001
10000CCC00000CCC00001
1000C111C000C111C0001
1000C1001C0C1001C0001
1000C10001C10001C0001
10000C100010001C00001
100000C1000001C000001
1000000C10001C0000001
10000000C101C00000001
10P000000C1C000000E01
100000000000000000001
111111111111111111111