111111
1C00E1
100001
1P00C1
111111