111111111111111111111111
100C00C0000010C000000011
1111111000C000C0111111C1
1P0C000001110000000001E1
100C00111100000111000001
100C000C0000000C00000001
111111111111111111111111